11111111111
1P000001101
1C000000E01
10000000C01
10000000C01
10000000C01
10000000C01
11111111111
