11111111111
1P000001111
1C000000E11
11111111111


