111111111111111
100C00001111111
110000P01111111
111111011111111
110000000000111
11000000000CE11
111111111111111