111111111111111
100100000000001
101E010C00C0001
100110000P00001
111111111111111