11111111111
1P00000E101
1C000000E01
11111111111
