11111111111
1P00000E101
1C000000101
11111111111
